NO ./sprites/north.xpm
SO ./sprites/south.xpm
WE ./sprites/west.xpm
EA ./sprites/east.xpm

F 208,176,132
C 142,200,216

111111
100001
10N001
100001
111111

