WE ./sprites/wall1.xpm
EA ./sprites/wall2.xpm
NO ./sprites/wall3.xpm
SO ./sprites/wall8.xpm

F 0,75,73
C 142,200,216

        11111111111 1111111111111
        10000000001 1000000000001
        10110000011110000N0000001
        1001000000000000000100001
111111111011000001110000000000001
100000000011000001110111111111111
11110111111111011100000010001
11000111111111011101010010001
11011100110101011100000010111
1001 100000000001100000010001111111111111111
1001110000000000110101000000111            1
1100000111010101110101101000001            1
11110111 1110101 101111010001111111111111111
11110111 1111111111111101111111
10000111111111111000000000000011
111111111111111111001111111111111
        1111111111101111111111111
        1000000000101000000000001
        1011000001101000000000001
111111111011000001100000000000001
100000000011000000000111111111111
11110111111111011100000000001
11000111111111011101010000001
11011100110101011100000000111
1001 100000000000000000000001111111111111111
1001110000000000000101000000111
1100000111010101110101100000001
11110111 1110101 10111100000111
11110111 1111111 1111111111111
100001
111111